User_ID,Age,Sex,Housing_Type,Groceries,Entertainment,Healthcare,Transportation,Savings,Total_Expenditure
0,67,male,own,4932,2613,1016,6872,11491,26924
1,22,female,own,5547,5045,4804,6136,5123,26655
2,49,male,own,2012,7943,4725,1180,9625,25485
3,45,male,free,9774,5632,1785,3915,9101,30207
4,53,male,free,8144,1640,4914,6052,12240,32990
5,35,male,free,8055,4370,3770,3384,3010,22589
6,53,male,own,9184,3058,4253,5510,7068,29073
7,35,male,rent,6749,5315,2292,5009,3260,22625
8,61,male,own,6346,6917,2432,4116,4638,24449
9,28,male,own,5523,6515,3058,5897,3314,24307
10,25,female,rent,8105,5609,3705,5191,11828,34438
11,24,female,rent,3932,2975,4337,2376,2327,15947
12,22,female,own,4993,6020,4351,3364,11372,30100
13,60,male,own,9471,4913,3844,1798,7636,27662
14,28,female,rent,5745,2757,3230,5703,5987,23422
15,32,female,own,7071,6305,1868,6685,11816,33745
16,53,male,own,9003,1624,3317,4853,2104,20901
17,25,male,own,2106,1197,3723,4094,14775,25895
18,44,female,free,7527,1412,3730,3248,2130,18047
19,31,male,own,8173,6255,1483,4813,14566,35290
20,48,male,own,6697,2566,1735,1216,5143,17357
21,44,male,rent,3473,3101,3184,6444,7261,23463
22,48,male,rent,8525,7293,1849,5415,3444,26526
23,44,male,own,4756,1417,4941,1514,12150,24778
24,26,male,own,7069,6552,2044,4576,2246,22487
25,36,male,own,7811,1448,4851,5299,10746,30155
26,39,male,own,8928,6741,864,3053,2695,22281
27,42,female,rent,8614,2284,2176,4527,7028,24629
28,34,male,own,3116,4932,4450,4984,7497,24979
29,63,male,own,9828,6115,2982,4162,7379,30466
30,36,male,own,3457,1831,4482,1584,8063,19417
31,27,male,own,3202,1227,3943,3047,11374,22793
32,30,male,own,8891,1831,2302,2488,9641,25153
33,57,male,rent,9405,1892,2459,5918,2958,22632
34,33,female,own,4327,5632,3034,6703,5747,25443
35,25,male,own,5633,2214,3506,2896,7546,21795
36,31,male,free,9985,5481,655,1521,8090,25732
37,37,male,own,8282,4800,600,6251,1451,21384
38,37,male,own,8900,5360,3856,2728,2678,23522
39,24,male,own,4031,6226,2951,2196,5985,21389
40,30,male,own,9615,1056,3683,4799,13993,33146
41,26,male,own,8719,2407,2222,3423,2069,18840
42,44,male,own,7678,4543,1807,5027,14423,33478
43,24,male,rent,3109,7227,3575,4972,4050,22933
44,58,female,free,6235,4750,3815,3413,9760,27973
45,35,female,own,9867,5082,1119,4072,5549,25689
46,39,male,own,7855,7109,4043,5204,12060,36271
47,23,female,rent,7746,6266,602,4280,5799,24693
48,39,male,own,9176,2470,2436,3929,6450,24461
49,28,female,own,5927,4661,2775,1047,3678,18088
50,29,male,own,2577,4181,1891,4661,13628,26938
51,30,male,own,8991,1153,2312,2881,11553,26890
52,25,male,own,5776,2628,2352,4867,13960,29583
53,31,male,own,6626,7605,3158,4295,6652,28336
54,57,male,free,5179,4409,3099,2071,5868,20626
55,26,male,own,8195,4616,1435,1012,5854,21112
56,52,male,own,8838,4868,2648,2936,7050,26340
57,31,female,own,2363,6417,1771,6229,3427,20207
58,23,female,own,7589,3418,4720,2064,7184,24975
59,23,female,rent,5652,3661,883,5802,14318,30316
60,27,male,own,3642,1502,2116,1841,13274,22375
61,50,male,own,5121,5996,4485,3349,13847,32798
62,61,male,free,9499,1871,2376,6935,6937,27618
63,25,male,own,8795,3000,3959,6124,3158,25036
64,26,female,own,6005,7112,3258,4014,2547,22936
65,48,male,own,8348,7282,3893,1475,10816,31814
66,29,female,own,6317,5209,1332,6046,2393,21297
67,22,male,own,7983,3510,3374,6767,7908,29542
68,37,male,free,8392,6147,2090,6201,2667,25497
69,25,female,own,2151,2056,2650,2393,5519,14769
70,30,female,own,4654,5001,3452,2673,3996,19776
71,46,male,rent,6666,1234,3589,6110,3391,20990
72,51,male,free,6082,6792,1312,6006,4784,24976
73,41,female,own,7191,3503,3982,2955,14295,31926
74,40,male,own,6046,5044,3784,2631,7750,25255
75,66,male,free,2716,3748,2051,1666,1077,11258
76,34,male,own,7452,7778,4931,5672,9578,35411
77,51,male,own,5747,3817,3399,1897,9156,24016
78,39,male,own,9206,4020,1340,2030,4457,21053
79,22,male,own,9813,7199,3408,6699,9917,37036
80,44,female,own,8039,2785,1738,4727,5255,22544
81,47,male,own,2431,7241,1103,4312,9621,24708
82,24,female,rent,4903,6815,3982,5721,11273,32694
83,58,female,own,7638,4739,3764,4389,13045,33575
84,52,male,own,9134,7467,3686,2158,4760,27205
85,29,female,own,5775,3892,756,6811,9964,27198
86,27,female,own,7298,4727,4157,1526,6399,24107
87,47,male,free,7945,1680,841,1244,6480,18190
88,30,male,own,8699,6703,3137,3412,1715,23666
89,28,male,own,9949,1335,4202,1471,1986,18943
90,56,male,own,2222,1854,974,3114,2112,10276
91,54,male,own,5220,1970,3966,5380,13610,30146
92,33,female,own,4074,1614,2524,5580,8161,21953
93,20,male,rent,9765,7501,1934,6209,9578,34987
94,54,male,own,4659,4206,2153,3979,10505,25502
95,58,male,rent,7172,3766,2579,1755,10631,25903
96,61,female,own,9666,6840,549,5752,4590,27397
97,34,male,own,3436,6935,1766,4948,7118,24203
98,36,male,own,2174,3723,1445,4267,2588,14197
99,36,male,rent,9716,7539,621,6213,4278,28367
100,41,male,rent,5719,7105,2546,3171,8302,26843
101,24,male,rent,5680,5314,3253,1226,14168,29641
102,24,female,own,9923,4394,2489,1988,1749,20543
103,35,male,rent,2497,6595,4476,2622,3164,19354
104,26,male,rent,6784,4927,4190,1526,7413,24840
105,39,male,own,2250,7468,730,6082,2028,18558
106,39,male,own,4731,4190,4396,6929,14588,34834
107,32,male,own,9777,7275,4182,4587,2090,27911
108,30,female,own,8328,4779,4388,3366,9480,30341
109,35,male,own,2663,2298,1093,6389,12705,25148
110,31,male,own,2383,5663,1499,5646,14288,29479
111,23,female,rent,2780,5988,4996,5893,14103,33760
112,28,male,rent,2073,7924,1267,5732,14808,31804
113,25,female,own,8083,4736,1068,5081,10101,29069
114,35,male,own,6721,7493,4572,4790,1776,25352
115,47,male,own,9490,5189,3178,1622,2113,21592
116,30,female,own,6759,6931,3750,1902,1925,21267
117,27,female,rent,2915,2772,1068,6581,1428,14764
118,23,female,own,6765,5516,1291,5771,6721,26064
119,36,male,own,7514,4159,1258,6308,11577,30816
120,25,female,own,7210,4487,1852,3729,2971,20249
121,41,female,rent,9688,6041,680,4362,1025,21796
122,24,male,rent,6375,5431,3541,3389,9953,28689
123,63,male,free,5257,6881,957,4979,8725,26799
124,27,female,rent,5852,4680,1361,4558,2950,19401
125,30,male,own,5746,3834,3270,2486,4021,19357
126,40,male,own,6334,7073,4042,6824,3082,27355
127,30,male,own,6379,3316,4727,6898,7945,29265
128,34,male,own,5702,6557,3479,5618,2166,23522
129,29,female,own,4481,3732,1547,5918,10600,26278
130,24,female,own,7089,4152,4249,6255,13986,35731
131,29,male,own,7797,6250,2411,2042,4139,22639
132,27,male,own,4421,2627,1946,5973,8640,23607
133,47,male,free,5462,1403,1267,1900,9324,19356
134,21,female,own,8525,5175,1970,2331,3203,21204
135,38,female,own,2938,4583,776,2206,8584,19087
136,27,male,own,2342,3909,1331,4881,12536,24999
137,66,male,own,6678,4236,1078,2729,12067,26788
138,35,male,own,2304,5773,1642,5308,7496,22523
139,44,female,rent,5501,7220,4701,4699,3823,25944
140,27,male,own,8950,5298,1868,6698,3339,26153
141,30,female,own,5350,6804,1580,6587,7188,27509
142,27,male,own,6326,5623,3504,2541,13877,31871
143,22,male,own,7265,2881,1662,2478,3687,17973
144,23,female,own,9947,5384,2966,1185,13922,33404
145,30,male,own,4179,3531,2790,5115,7382,22997
146,39,female,own,2338,7068,4415,4850,4328,22999
147,51,female,own,7606,2048,3488,5741,6598,25481
148,28,male,own,7089,2984,2293,4614,2192,19172
149,46,male,own,8280,4471,2099,1019,7070,22939
150,42,male,free,2221,3707,1553,1242,6095,14818
151,38,male,own,6977,5970,3520,1486,11737,29690
152,24,male,own,3178,5367,3909,4761,1410,18625
153,29,female,rent,7486,1327,1780,4886,5449,20928
154,36,male,rent,4893,7182,4496,6137,11282,33990
155,20,female,rent,5209,4372,3284,1062,5115,19042
156,48,male,own,3789,5901,3311,2472,6958,22431
157,45,male,own,6707,3731,4032,2119,3300,19889
158,38,male,own,3484,2869,3708,2673,1972,14706
159,34,male,own,3894,3386,2509,3363,11215,24367
160,36,male,own,3449,7737,1512,1243,1150,15091
161,30,female,own,8343,2566,2873,1778,11195,26755
162,36,male,own,2854,1566,4650,5861,8176,23107
163,70,male,free,2419,2707,1710,6726,9923,23485
164,36,male,own,6476,2010,2345,1771,8766,21368
165,32,male,own,7482,7655,1007,2376,6714,25234
166,33,female,own,5621,4243,3985,4965,2384,21198
167,20,female,own,2842,6102,730,2323,10982,22979
168,25,female,rent,4553,3737,4591,5462,8712,27055
169,31,male,own,9477,2821,998,3907,9489,26692
170,33,male,rent,3527,5474,1323,6106,7583,24013
171,26,female,own,9114,7496,1417,6502,10850,35379
172,34,female,own,4305,5387,2491,4922,1879,18984
173,33,male,own,6685,4950,3226,1525,13976,30362
174,26,male,own,4959,2788,4650,1248,1146,14791
175,53,female,own,2193,1345,3256,4155,14293,25242
176,42,male,own,7070,5824,3734,1272,12516,30416
177,52,male,own,9482,4805,3310,4472,5763,27832
178,31,male,rent,7555,5202,1283,4727,10879,29646
179,65,male,own,5885,6261,2032,2204,8791,25173
180,28,male,own,2308,7836,4855,4753,8660,28412
181,30,male,own,3700,2999,2670,2020,1941,13330
182,40,male,own,9759,1547,1912,4099,1945,19262
183,50,male,own,5310,4080,3943,2528,3629,19490
184,36,male,own,2592,4378,4533,6008,2997,20508
185,31,male,own,7897,6114,4645,1929,3852,24437
186,74,female,free,9188,7326,2351,2140,4334,25339
187,68,male,free,8238,7756,3870,4460,2295,26619
188,20,male,own,3995,3558,1202,5224,5306,19285
189,33,female,own,2528,7309,3489,2342,8349,24017
190,54,male,own,8266,6651,3070,6350,2695,27032
191,34,male,free,7430,5966,689,2938,10592,27615
192,36,male,own,4069,2857,2636,3483,1446,14491
193,29,male,rent,4854,2991,2486,3183,12926,26440
194,21,male,rent,8233,6880,1517,3622,14960,35212
195,34,female,own,4553,5876,1275,5283,5761,22748
196,28,female,own,8791,4468,2810,1536,14549,32154
197,27,female,rent,9289,1979,4736,5667,3224,24895
198,36,male,free,4892,5880,693,4017,12942,28424
199,40,male,own,9528,5887,3663,4261,1839,25178
200,52,male,own,3834,6947,538,2319,12436,26074
201,27,male,own,9285,2616,3307,5825,13398,34431
202,26,male,own,4373,1208,1169,5907,6461,19118
203,21,male,rent,9438,6715,3293,1153,10111,30710
204,38,male,own,9269,1724,2551,1029,9356,23929
205,38,male,free,2549,6758,1899,5631,13416,30253
206,43,male,own,5156,3144,1582,5604,8931,24417
207,26,male,own,7545,5860,1600,2207,4784,21996
208,21,male,own,8733,7415,3988,3879,8863,32878
209,55,male,own,3528,3199,1220,1496,11572,21015
210,33,male,own,8673,7559,4373,3269,14648,38522
211,45,female,own,8102,5270,2841,1683,10259,28155
212,50,male,own,7764,4937,4723,1062,13821,32307
213,66,male,own,9587,6741,1838,3302,2948,24416
214,51,male,own,2275,6964,3342,4543,8113,25237
215,39,female,own,8696,7854,4624,4281,4840,30295
216,31,male,own,9267,4783,1389,5228,8035,28702
217,23,male,own,2246,3545,2591,3309,4332,16023
218,24,male,rent,4427,6591,4644,3823,7077,26562
219,64,female,own,6723,3723,2681,3177,7889,24193
220,26,male,own,9086,7807,1268,6256,6671,31088
221,23,female,rent,6088,6250,2520,5744,12810,33412
222,30,male,own,4486,1979,4521,2404,12317,25707
223,32,male,own,7833,5065,4739,1213,3294,22144
224,30,male,own,6275,1227,4928,6774,10322,29526
225,27,male,own,9812,3107,4981,5422,1752,25074
226,27,male,own,7553,2390,603,2892,3756,17194
227,53,male,free,5167,5192,3228,1465,11503,26555
228,22,male,own,3988,3179,2827,1370,11416,22780
229,22,male,free,5013,4986,3378,5875,8793,28045
230,26,male,own,2077,7710,1802,1184,3842,16615
231,51,male,free,3823,1961,4343,3015,10311,23453
232,35,male,own,3373,1908,2850,5880,4183,18194
233,25,male,own,9427,4440,1151,6391,3990,25399
234,42,male,own,4381,2507,3635,1159,3990,15672
235,30,male,own,6714,2997,4259,5013,8300,27283
236,23,male,own,9145,6984,796,2589,8316,27830
237,61,male,rent,2928,1058,1799,2307,9860,17952
238,35,female,own,7085,6190,1415,3094,11200,28984
239,39,male,own,4722,1213,3437,1325,2547,13244
240,29,female,own,6272,5200,1204,1420,5778,19874
241,51,male,own,2601,3943,1572,4678,2683,15477
242,24,male,free,9969,1208,927,6726,6506,25336
243,27,female,own,7530,2535,3057,3901,9153,26176
244,35,female,own,2805,1949,599,1515,8698,15566
245,25,male,own,7806,6683,4005,1983,4687,25164
246,52,male,own,4098,7417,4718,2214,13195,31642
247,35,male,rent,6604,4992,4402,6088,4002,26088
248,26,male,own,9376,4434,3187,6861,6168,30026
249,22,female,rent,7755,1519,4236,3295,1696,18501
250,39,female,own,4966,4385,4636,5770,1774,21531
251,46,female,own,2252,4652,2924,3080,14692,27600
252,24,female,own,2580,1967,2237,3405,4441,14630
253,35,male,own,6827,4353,4191,5818,8043,29232
254,24,male,own,3343,3524,2902,4833,6684,21286
255,27,male,own,6628,2565,1434,6457,10766,27850
256,35,male,own,6389,3595,2005,5181,12756,29926
257,29,male,free,5136,3568,2924,6164,11757,29549
258,23,female,own,6479,5559,3936,4244,2253,22471
259,57,female,own,3365,4032,1725,4232,4924,18278
260,27,male,own,5440,7188,3204,4435,13867,34134
261,55,female,own,3023,2343,1016,1938,3848,12168
262,36,male,free,5345,3782,1643,6557,9545,26872
263,57,female,free,8169,7287,886,3170,12728,32240
264,32,male,own,2125,6486,3479,1276,9221,22587
265,37,male,own,8952,1478,677,3488,11439,26034
266,36,male,own,8173,4513,4008,3076,8439,28209
267,38,female,own,8998,6664,2143,4662,8210,30677
268,45,male,own,5356,5966,2271,2602,6732,22927
269,25,male,own,6388,2866,3464,6066,6912,25696
270,32,male,own,3433,7297,4800,4465,10178,30173
271,37,female,rent,7270,1224,2431,2487,6719,20131
272,36,male,free,5862,2000,4494,1071,5600,19027
273,28,male,own,5627,1192,887,6935,4938,19579
274,34,male,own,6370,1564,3547,3541,3781,18803
275,32,male,own,3016,7743,1295,1096,4943,18093
276,26,female,own,6579,2006,3551,3039,12289,27464
277,49,male,own,8474,2830,3173,1980,14425,30882
278,32,female,own,3886,5791,1667,2247,10777,24368
279,29,male,rent,2621,4509,4073,5927,2638,19768
280,23,male,rent,9415,6698,1135,5558,1341,24147
281,50,male,own,7815,2819,821,3063,12631,27149
282,49,male,own,6587,5419,2462,4289,9366,28123
283,63,male,own,5363,5227,4430,4866,2196,22082
284,37,male,own,6272,7995,1020,1195,10832,27314
285,35,female,own,9693,1753,3580,2335,2302,19663
286,26,male,own,3738,5732,587,1752,12208,24017
287,31,male,free,3342,3641,3434,1091,14917,26425
288,49,female,own,7351,1501,3303,5508,12323,29986
289,48,male,own,7437,2870,4905,2318,13283,30813
290,26,male,own,5553,4905,4394,4159,11919,30930
291,28,male,rent,8501,1505,4469,4563,11199,30237
292,44,female,free,2331,4484,644,2928,10028,20415
293,56,male,free,2629,1740,2472,1633,6295,14769
294,46,male,own,7865,5967,2574,1934,2365,20705
295,26,female,own,4560,4239,3849,6881,9445,28974
296,20,female,rent,4935,6871,932,5618,5796,24152
297,45,male,own,6996,7522,1707,6206,1702,24133
298,43,male,own,9208,4500,1578,3063,10989,29338
299,32,male,own,3184,3542,1610,1129,2739,12204
300,54,female,own,9243,4286,843,2280,5637,22289
301,42,female,own,3744,1675,3085,5489,1501,15494
302,37,male,own,4235,7195,991,2711,6052,21184
303,49,male,own,3063,7524,1024,5312,4088,21011
304,44,male,free,4836,3630,1273,4929,9839,24507
305,33,male,own,5144,4843,1462,1858,1898,15205
306,24,female,rent,6001,1680,4489,5733,5715,23618
307,33,male,own,2445,6991,1174,6813,14853,32276
308,24,female,own,4965,4410,3118,1972,14311,28776
309,22,male,rent,7759,7316,4206,5967,13243,38491
310,40,male,free,3011,6860,3092,2646,4444,20053
311,25,male,own,7351,7978,4717,1924,10992,32962
312,26,female,own,7470,7091,664,1122,10107,26454
313,25,male,own,7860,6344,2238,3469,7747,27658
314,29,male,own,9246,5730,746,3882,5844,25448
315,31,male,own,2621,5900,1328,5900,13048,28797
316,38,male,own,9022,1066,4086,2971,5474,22619
317,48,female,own,4104,7268,1638,6838,7893,27741
318,32,male,own,2335,2467,3549,3738,1320,13409
319,27,female,own,4542,1043,3872,4272,1171,14900
320,28,male,own,2879,2021,1853,4614,8544,19911
321,32,male,own,3692,4681,4164,1058,3479,17074
322,34,male,free,8114,5807,2464,5281,14602,36268
323,28,male,own,8517,3582,4409,5617,11601,33726
324,36,female,own,9124,4415,3011,1419,6704,24673
325,39,male,own,8718,6169,3084,4832,7925,30728
326,49,male,rent,7983,2555,4695,1773,5450,22456
327,34,female,own,3824,6034,1022,4060,4724,19664
328,31,male,own,4823,3021,4864,3499,8251,24458
329,28,male,own,8659,4245,2439,1414,6481,23238
330,75,male,free,6843,3893,4564,4414,6066,25780
331,30,female,own,3668,1878,1521,4953,12811,24831
332,24,female,own,8049,3193,3764,6301,9803,31110
333,24,female,rent,2497,3783,2000,5827,13520,27627
334,23,male,rent,4336,1413,1057,6302,10572,23680
335,44,male,rent,9116,6629,2303,4974,4176,27198
336,23,female,own,5830,5311,3933,4832,13391,33297
337,24,female,rent,6476,2358,2034,2701,10100,23669
338,28,male,own,7301,1165,4162,6507,4293,23428
339,31,male,own,4664,3610,854,1761,10751,21640
340,24,female,free,4875,6999,4559,2963,7993,27389
341,26,female,rent,3423,7002,2806,6564,9985,29780
342,25,male,rent,9710,7588,3399,6505,6355,33557
343,33,male,own,7614,3147,814,5668,6993,24236
344,37,male,own,5726,3457,3844,5754,4124,22905
345,43,female,own,3338,7830,2057,6724,8657,28606
346,23,male,own,8354,5148,3572,3241,4194,24509
347,23,female,rent,5108,7496,3154,6248,14418,36424
348,34,male,own,5324,7689,1692,4557,11958,31220
349,32,male,free,9923,2768,4502,2624,5782,25599
350,23,female,rent,8175,2747,4256,6109,14337,35624
351,29,female,own,9073,2875,3709,2392,9102,27151
352,38,male,own,9074,7096,4217,1125,8689,30201
353,28,male,rent,6748,3674,3338,1724,6168,21652
354,46,male,free,7684,4847,1345,3411,3420,20707
355,23,male,own,4627,7103,4842,4015,10239,30826
356,49,male,own,5442,5631,3106,4102,6062,24343
357,26,male,own,9220,7606,4882,2232,10665,34605
358,28,male,own,3711,7268,4215,1808,5708,22710
359,23,female,rent,9416,5770,4824,2157,5371,27538
360,61,male,free,3619,4445,4349,5276,13070,30759
361,37,male,own,2394,4239,2261,1868,6608,17370
362,36,female,own,7920,4645,2542,2635,3031,20773
363,21,male,rent,7810,6119,3502,4652,3601,25684
364,25,male,own,3350,4550,3666,1961,4994,18521
365,36,male,own,7997,4355,2134,6089,2835,23410
366,27,male,own,7270,2570,1692,4985,5191,21708
367,22,female,rent,7267,2385,3536,6481,14171,33840
368,42,male,own,7992,6261,2134,1689,9373,27449
369,40,female,rent,4288,7962,2906,6990,9057,31203
370,36,male,own,2363,2376,818,4681,5846,16084
371,33,male,own,8988,5986,1454,5865,3592,25885
372,23,female,rent,4096,1691,4158,6760,6151,22856
373,63,male,free,8201,5822,3565,1093,8774,27455
374,60,female,free,7645,2744,1947,1817,12602,26755
375,37,female,rent,6032,4129,2912,2779,14961,30813
376,34,male,own,3123,5200,2438,5842,6423,23026
377,36,male,free,6759,6894,1852,2311,14120,31936
378,57,male,free,4602,3559,1609,2214,5679,17663
379,52,female,own,9774,1469,4821,4537,2895,23496
380,39,male,own,6920,1135,2119,5553,10688,26415
381,38,female,free,4174,6083,1446,5836,8441,25980
382,25,female,rent,5549,4322,4684,3616,5139,23310
383,26,male,own,5697,6973,2766,4645,13304,33385
384,26,male,own,5047,6825,842,2852,11232,26798
385,25,female,own,8699,5933,4482,4603,10003,33720
386,21,female,rent,5393,3346,3765,3113,11569,27186
387,40,male,own,4334,7311,2181,2548,6531,22905
388,27,male,own,5082,5627,2348,3413,3785,20255
389,27,female,own,5310,5407,1170,4866,3112,19865
390,30,male,own,5017,2794,722,1562,8333,18428
391,19,female,rent,6756,4214,1339,4211,10544,27064
392,39,male,free,6977,1018,1402,5460,11578,26435
393,31,female,own,8303,7463,3177,4418,5645,29006
394,31,male,own,6989,7493,4101,1199,13327,33109
395,32,male,rent,6421,6676,2730,5915,14069,35811
396,55,female,free,7186,1223,1882,1941,6229,18461
397,46,male,own,9791,3251,3901,2344,11883,31170
398,46,male,rent,5299,6427,2507,3770,8937,26940
399,43,female,own,6518,6747,4797,5609,9568,33239
400,39,male,own,4496,3198,3984,3511,9033,24222
401,28,male,own,5236,3665,2058,4221,11085,26265
402,27,male,own,9671,6366,3265,3926,13025,36253
403,27,male,own,5630,5017,2521,2673,10804,26645
404,43,male,own,8770,2550,4288,1870,5275,22753
405,22,male,own,2682,2398,1288,3865,5207,15440
406,43,male,own,6842,7781,4607,2941,14903,37074
407,27,male,own,5057,6379,646,3464,11615,27161
408,26,male,own,9838,2365,4235,2948,9103,28489
409,28,male,own,7217,3194,3413,1562,5432,20818
410,20,female,own,6743,4337,4219,1585,14934,31818
411,35,male,own,7493,1105,1461,3079,12076,25214
412,42,male,own,4458,3653,3458,6174,13011,30754
413,40,male,rent,4629,5546,2448,1912,11166,25701
414,35,female,own,8212,6844,3354,1222,12065,31697
415,35,male,own,7029,4129,1784,5639,4463,23044
416,33,male,own,4412,6146,3452,2763,9625,26398
417,23,female,rent,8838,4908,3108,2643,4073,23570
418,31,female,own,6545,6043,4284,1480,3350,21702
419,33,female,own,7624,2399,1037,6677,14787,32524
420,20,female,rent,3823,6508,2033,4425,8154,24943
421,30,male,own,8266,1553,1763,2514,13085,27181
422,47,male,own,8101,3325,4184,4511,4500,24621
423,34,male,own,3743,4187,1330,2550,11839,23649
424,25,female,own,6665,2746,3573,4616,2009,19609
425,21,male,rent,7321,6588,4643,3721,12468,34741
426,29,male,own,4752,2535,1243,1902,7391,17823
427,46,male,own,3096,7113,3811,2134,7962,24116
428,20,male,own,5784,1128,3991,6216,1453,18572
429,55,female,free,3498,5914,4721,5212,7149,26494
430,74,male,own,7294,4477,599,4053,12265,28688
431,29,male,own,6153,3128,1611,4666,4539,20097
432,36,male,free,7358,7280,4031,6326,12970,37965
433,33,male,own,3245,3589,2516,5893,14304,29547
434,25,male,own,8405,6251,1850,4995,1489,22990
435,25,male,own,4310,1064,4622,6674,12467,29137
436,23,male,rent,2022,3764,2854,1844,7472,17956
437,37,female,own,6683,3990,4850,1447,1790,18760
438,65,male,own,7244,2422,2060,6017,14376,32119
439,26,female,own,7839,7012,829,6879,1515,24074
440,39,male,own,2492,1793,2246,6019,6137,18687
441,30,female,own,5989,6822,2653,1240,8078,24782
442,29,male,own,6428,4668,919,1025,7588,20628
443,41,male,own,6165,4711,3994,1305,2360,18535
444,30,female,own,7105,1593,3682,4427,3995,20802
445,41,female,rent,3932,5187,3838,5450,11974,30381
446,34,female,own,9122,2189,1932,6155,5114,24512
447,35,male,own,8835,1207,3147,4669,13740,31598
448,55,female,own,8714,5778,2010,4987,10671,32160
449,61,male,own,7463,2327,2744,5793,6956,25283
450,30,male,own,6115,6604,4596,6629,3939,27883
451,29,female,own,5101,2952,1245,1664,6298,17260
452,34,male,own,7645,2187,1995,6134,4721,22682
453,35,male,own,5939,2385,3082,5498,11017,27921
454,31,male,own,3543,5295,4535,3042,9234,25649
455,29,female,own,7637,7374,1261,2904,10262,29438
456,36,male,rent,8451,5912,2767,3634,4805,25569
457,35,male,free,6108,2195,2658,3696,1841,16498
458,27,female,own,5835,2649,4128,2051,5478,20141
459,32,male,own,8277,4414,4731,5273,4265,26960
460,37,male,own,7364,5657,3898,3803,3500,24222
461,36,male,own,5445,1001,1580,1086,2764,11876
462,34,female,rent,2722,4836,872,2880,1071,12381
463,38,male,own,7221,2973,2728,6436,8356,27714
464,34,male,own,7375,2878,520,3800,6390,20963
465,63,male,own,7146,7935,1373,3009,12959,32422
466,29,female,rent,9620,5017,4242,3728,13927,36534
467,32,male,own,5436,2602,3534,4600,6662,22834
468,26,female,own,8150,1218,2490,6168,8684,26710
469,35,male,own,5798,1055,2397,4771,6539,20560
470,22,male,rent,9846,4774,4687,1561,9422,30290
471,23,female,own,9455,3779,4740,4140,2155,24269
472,28,male,own,4646,4320,2369,5914,12312,29561
473,36,male,own,9537,6847,2463,1638,11077,31562
474,33,male,own,9503,7171,1048,1572,5467,24761
475,26,female,rent,2270,7134,4711,6887,12012,33014
476,24,male,own,3702,1048,3341,5216,10582,23889
477,25,male,own,3621,4885,913,1121,11354,21894
478,39,male,own,7066,4957,4589,6359,11785,34756
479,44,male,own,2390,3338,4961,6378,13909,30976
480,23,female,own,4602,4463,1585,2509,8040,21199
481,26,male,own,4366,6329,3300,6867,5385,26247
482,57,female,rent,6218,7349,4630,5672,6826,30695
483,30,female,own,5166,2021,1054,5775,7380,21396
484,44,male,own,8068,5100,4972,2228,12201,32569
485,47,male,own,7491,1776,2943,3816,8354,24380
486,52,male,own,7746,7361,4608,6771,7208,33694
487,62,female,free,7833,1979,3689,4096,7070,24667
488,35,male,rent,9307,4200,2807,6769,10375,33458
489,26,male,rent,4928,7783,4802,2803,13972,34288
490,26,male,own,6893,1502,2760,3558,5673,20386
491,42,female,free,8718,1213,4499,2745,5856,23031
492,27,female,own,3831,3747,3205,2922,10877,24582
493,38,male,own,6104,6362,1707,6987,12842,34002
494,39,male,rent,3139,2339,4319,3978,3003,16778
495,20,male,own,5514,7648,3829,4230,1821,23042
496,29,male,rent,8644,5041,2212,2918,5670,24485
497,40,male,own,5835,2666,2064,4985,4773,20323
498,32,male,own,6561,5000,4102,6413,13386,35462
499,28,male,own,4754,6705,3487,4591,7937,27474
500,27,female,own,4220,2788,738,3547,12477,23770
501,42,male,free,8832,1083,3309,1539,7257,22020
502,49,male,own,2023,7381,2344,6858,6709,25315
503,38,male,own,6245,5264,1833,2961,6740,23043
504,24,female,rent,5299,3705,738,3542,4985,18269
505,27,male,own,2499,6546,4798,6997,14621,35461
506,36,male,own,7844,7978,3547,5920,11601,36890
507,34,male,own,7051,3938,4338,6929,5651,27907
508,28,male,own,7484,7953,3122,4005,14929,37493
509,45,male,own,3367,2593,3750,4751,14435,28896
510,26,male,own,8667,2546,3374,5911,11336,31834
511,32,male,free,8430,2562,3849,4371,6438,25650
512,26,male,rent,9366,6715,4451,5717,5988,32237
513,20,male,rent,4048,5047,3980,3501,6815,23391
514,54,male,own,7878,2214,2636,2493,14146,29367
515,37,female,own,3845,4605,4180,3597,14902,31129
516,40,male,own,9487,4520,4121,2816,8939,29883
517,23,female,rent,7888,2356,1955,6922,6219,25340
518,43,male,own,4012,6680,2508,3357,1859,18416
519,36,male,free,3708,2868,3016,3449,2626,15667
520,44,male,free,6016,4717,2453,1606,1413,16205
521,24,female,own,2325,4102,4212,2045,11143,23827
522,53,male,free,6469,7967,1775,3484,2790,22485
523,23,female,own,8927,3733,4235,5792,13769,36456
524,26,female,own,7656,2911,2540,6940,14170,34217
525,30,male,own,2912,3455,992,3338,1522,12219
526,31,female,own,8854,1235,4049,6626,4800,25564
527,42,male,own,7763,6159,1624,4843,1477,21866
528,31,male,rent,3113,5565,4718,3615,12770,29781
529,41,male,own,3658,6935,3035,2200,10558,26386
530,32,male,own,4435,2914,2772,6263,12838,29222
531,28,female,rent,6606,4962,1989,1838,1413,16808
532,41,male,rent,5431,7698,746,2322,9073,25270
533,26,male,own,8229,2174,1952,3164,7724,23243
534,25,male,own,7269,1203,4048,3339,14247,30106
535,33,male,rent,4829,6604,3367,2231,1946,18977
536,75,female,own,9546,4264,4902,6543,2619,27874
537,37,female,own,2607,3684,2174,2583,13696,24744
538,42,male,free,9922,3754,1089,6139,3986,24890
539,45,female,own,2614,4296,3027,3022,4936,17895
540,23,male,rent,2752,5491,1517,2221,3505,15486
541,60,male,free,5378,4767,2734,1963,1274,16116
542,31,male,own,6760,6886,4881,3996,13999,36522
543,34,male,own,8162,7653,2198,2159,11850,32022
544,61,male,own,3771,3414,1413,4578,3690,16866
545,43,male,free,6170,3262,3169,5752,4685,23038
546,37,female,own,8718,7739,4467,2305,10555,33784
547,32,male,own,4278,3350,2178,2423,7303,19532
548,24,female,own,9454,7304,2834,5821,11588,37001
549,35,male,free,7341,3054,4426,3356,7670,25847
550,23,female,own,7970,6316,3767,4197,8290,30540
551,45,male,own,6016,1201,1905,5675,7276,22073
552,34,male,own,2948,3459,1123,1671,11701,20902
553,27,male,own,8549,6358,2979,1526,13001,32413
554,67,female,own,3391,7811,3874,4554,4150,23780
555,22,male,own,7891,3510,2052,6892,9703,30048
556,28,female,own,8169,7653,878,3791,11759,32250
557,29,female,own,5188,1591,1826,6912,7440,22957
558,27,male,own,4845,1264,2341,5717,3430,17597
559,31,male,own,9342,4444,1481,2504,9675,27446
560,49,male,free,6024,4436,2832,4744,13253,31289
561,24,male,rent,6151,5055,1132,5567,3781,21686
562,29,female,own,5413,7163,2522,4022,8030,27150
563,37,male,free,5516,4938,1191,6065,13099,30809
564,37,male,own,7386,6241,3048,3489,8716,28880
565,23,female,rent,4989,2069,1398,1047,12394,21897
566,36,male,own,9701,5917,4231,1898,8002,29749
567,34,male,own,4128,3036,2320,4858,10986,25328
568,41,male,own,3595,1165,2946,4509,13365,25580
569,31,female,own,5984,2782,855,6142,3510,19273
570,23,female,rent,4045,7381,4678,4202,8062,28368
571,38,male,own,7067,2864,1372,2848,3846,17997
572,26,female,rent,6308,4346,2349,3935,13348,30286
573,22,female,own,6486,5143,4703,2823,3171,22326
574,27,male,own,6790,2301,3542,6053,3992,22678
575,24,female,own,8244,6650,3343,5624,13070,36931
576,27,female,own,6650,2166,727,1141,3147,13831
577,33,female,own,7870,1498,2179,2040,2076,15663
578,27,male,own,3647,5575,2777,2287,2972,17258
579,27,male,own,4528,2067,3837,6771,5500,22703
580,30,male,own,4094,2975,4697,5018,9185,25969
581,49,male,own,7869,4990,1492,1535,9882,25768
582,26,female,rent,5729,1383,3331,2727,10331,23501
583,33,male,rent,2750,4774,3669,2828,13505,27526
584,52,female,free,2291,2407,1208,6333,11195,23434
585,20,female,rent,4843,1476,2232,6661,5905,21117
586,36,male,rent,7098,3717,3213,1868,12565,28461
587,21,male,own,4174,3127,1826,5735,14222,29084
588,47,male,own,2419,6888,3729,1392,12455,26883
589,60,male,own,4594,1483,1909,5951,9804,23741
590,58,female,own,9856,4393,4590,2123,1927,22889
591,42,female,rent,8471,6423,3444,2371,6521,27230
592,36,female,own,9693,4154,3623,1323,6421,25214
593,20,female,rent,2210,4437,2113,3020,14808,26588
594,40,male,own,8415,6759,3259,2388,14698,35519
595,32,female,own,7097,4831,2111,4650,10146,28835
596,23,female,rent,4914,6584,4803,5033,4105,25439
597,36,male,own,2406,3737,2085,4744,6628,19600
598,31,male,own,3600,5231,4523,1884,1956,17194
599,32,male,free,3760,5539,4152,4399,4767,22617
600,45,female,own,9546,7912,4639,4411,14288,40796
601,30,female,own,7095,4430,3994,5554,7108,28181
602,34,female,free,8780,7462,3887,1202,1014,22345
603,28,female,own,9211,2384,3209,4390,12124,31318
604,23,female,own,8426,2823,4205,5908,4869,26231
605,22,male,own,5021,2409,2702,2994,4353,17479
606,74,male,own,6423,5862,3836,4005,12931,33057
607,50,female,free,4199,1570,3311,4099,5037,18216
608,33,male,own,7550,2576,4748,1748,7176,23798
609,45,male,free,4127,5268,1323,3964,9246,23928
610,22,female,own,5274,5887,3573,4200,6243,25177
611,48,female,free,2101,1600,906,3271,1182,9060
612,29,female,own,4096,7627,1096,1763,8120,22702
613,22,female,rent,8493,2733,2427,6834,5617,26104
614,22,female,own,6187,5236,3938,1444,5215,22020
615,48,male,own,2375,7327,1710,6078,5197,22687
616,27,male,free,2774,4524,3934,6328,10209,27769
617,37,male,rent,6556,5151,4578,2113,9812,28210
618,21,female,rent,8645,6076,3855,1243,7968,27787
619,49,male,own,2132,2523,3386,4036,14396,26473
620,27,male,own,6410,4700,4259,3694,4804,23867
621,32,male,own,3171,7099,3227,2316,1503,17316
622,38,male,own,9953,7161,4338,4970,9215,35637
623,22,female,rent,6845,6866,2535,4094,4612,24952
624,65,male,free,4646,1356,1571,2888,1235,11696
625,35,male,own,2966,4791,4034,6766,6423,24980
626,41,male,own,5951,7555,1335,4765,5005,24611
627,29,male,own,2245,2319,1690,6184,9346,21784
628,36,male,own,5129,1191,4346,1941,7989,20596
629,64,male,own,8713,3071,4957,5680,5256,27677
630,28,female,own,3801,4700,2677,5036,14761,30975
631,44,male,own,7147,2182,2319,6058,6514,24220
632,23,male,own,7679,1226,1251,6873,4997,22026
633,19,female,rent,3086,5560,3390,2426,5699,20161
634,25,female,own,9485,2886,1059,5683,5650,24763
635,47,male,own,6782,3969,3615,5882,8924,29172
636,28,female,own,3018,3626,2230,4962,8604,22440
637,21,male,own,5852,7610,4824,1024,3184,22494
638,34,female,own,9907,7499,4143,2124,2932,26605
639,26,male,own,3484,5666,2705,3407,6661,21923
640,27,female,own,2172,7342,3275,3942,2607,19338
641,38,male,own,7438,1357,4214,5495,1028,19532
642,40,male,own,3248,4744,2319,3768,13333,27412
643,33,male,own,2101,4630,886,5156,5424,18197
644,32,male,own,7858,2722,3161,4861,1803,20405
645,27,male,rent,8524,4142,784,3428,14538,31416
646,32,male,own,5564,6621,2587,3170,11269,29211
647,26,female,own,2839,1306,2524,5678,10417,22764
648,38,male,free,8704,4119,3002,4093,8221,28139
649,40,male,rent,6838,5446,4322,4475,4962,26043
650,50,male,free,4918,7041,3342,4742,6916,26959
651,37,male,own,6244,6101,4419,6624,10804,34192
652,45,male,own,5998,3072,955,6548,2493,19066
653,42,male,own,3168,6669,2146,6104,9765,27852
654,35,male,own,6308,2507,4367,6198,7899,27279
655,22,male,free,6669,2958,806,2533,8146,21112
656,41,male,own,6042,1661,2332,6904,10964,27903
657,37,male,own,5857,1555,2226,3296,9419,22353
658,28,female,own,6234,2764,4619,4178,1449,19244
659,41,male,own,5329,1509,3452,3522,9644,23456
660,23,male,rent,6469,5726,1356,3262,4422,21235
661,23,male,own,2779,3897,3495,5235,13997,29403
662,50,male,own,4908,2788,675,6863,2970,18204
663,35,male,own,4260,4730,646,4788,10245,24669
664,50,female,own,4124,6836,1021,5458,10616,28055
665,27,male,own,3256,2948,2553,5998,3157,17912
666,34,male,own,8973,2180,3794,1288,4931,21166
667,27,female,own,3122,7102,789,5522,9477,26012
668,43,male,rent,6343,1144,3654,5010,4720,20871
669,47,male,own,7826,4088,2903,4003,13679,32499
670,27,male,own,6419,7158,2498,4795,4168,25038
671,31,male,own,6478,2700,2105,4349,12313,27945
672,42,male,own,2535,7275,4395,1150,9593,24948
673,24,male,own,2267,1485,4516,2750,3929,14947
674,41,male,own,8966,2056,2765,2248,4756,20791
675,26,female,rent,9931,5166,2040,2496,8839,28472
676,33,male,own,6061,4802,4446,3106,11800,30215
677,24,male,own,2185,7366,2059,6970,2869,21449
678,64,male,rent,2710,5180,2166,3133,11429,24618
679,26,female,own,4263,2953,1323,4469,5495,18503
680,56,female,own,7094,1272,2019,4752,3708,18845
681,37,male,free,7082,7428,1406,1014,12026,28956
682,33,male,own,9559,5068,4483,1128,1070,21308
683,47,male,free,4772,6517,3374,2307,12560,29530
684,31,male,own,2113,2202,1073,3602,1257,10247
685,34,male,free,2490,2643,4053,5399,8032,22617
686,27,male,own,3089,2980,3470,6385,4333,20257
687,30,male,free,5756,5035,4105,4660,6938,26494
688,35,male,own,4431,5576,3641,4127,6486,24261
689,31,male,own,5277,2960,1617,5086,7549,22489
690,25,male,own,4669,3887,3191,5781,8646,26174
691,25,female,own,3361,5363,2921,4623,4171,20439
692,29,male,own,4681,4215,2277,2187,13193,26553
693,44,male,own,9855,5413,2060,6478,7929,31735
694,28,male,own,5604,6651,2197,5317,7012,26781
695,50,male,rent,2916,4056,4280,3332,12732,27316
696,29,male,own,6789,7992,3399,6813,14044,39037
697,38,female,own,9053,6005,2115,2880,3230,23283
698,24,male,own,6769,2726,755,2746,1700,14696
699,40,male,rent,6406,1566,2040,6501,7147,23660
700,29,female,rent,2328,4894,3978,2028,13242,26470
701,46,male,free,5954,6527,4741,6404,4008,27634
702,47,female,free,3011,6790,4894,3756,2900,21351
703,41,male,own,6370,2120,3414,1296,10707,23907
704,32,female,own,4538,6030,4615,2354,6781,24318
705,35,female,free,7359,6586,866,2105,11645,28561
706,24,male,own,4545,7864,782,2790,1916,17897
707,25,female,rent,4861,4508,4798,1508,5604,21279
708,25,female,own,5672,4667,1439,4757,5631,22166
709,37,male,own,3798,3377,2399,2133,10875,22582
710,32,male,own,6634,2222,4418,4584,8143,26001
711,35,female,free,9994,5272,3782,6544,6486,32078
712,46,male,own,2510,2814,2787,4604,2141,14856
713,25,male,own,7375,3719,2083,5357,4689,23223
714,27,male,own,9475,7995,3687,6647,14966,42770
715,63,male,own,4759,2928,1197,3333,14690,26907
716,40,male,own,9547,2897,1710,2671,1936,18761
717,32,male,free,8648,2864,967,1135,6635,20249
718,31,male,own,5162,4355,4400,4902,2711,21530
719,31,male,own,9939,3839,4779,5886,8907,33350
720,34,male,own,8980,2517,4510,5189,12976,34172
721,24,female,rent,7324,6649,1087,6640,8985,30685
722,24,female,own,9958,7248,1446,6091,6425,31168
723,66,female,own,4572,3133,2507,4737,7488,22437
724,21,female,rent,6615,5996,1408,3552,7852,25423
725,41,female,own,6222,2439,1438,5580,4450,20129
726,47,male,own,5323,6888,3878,5920,10888,32897
727,25,female,rent,5074,3145,2393,5543,6002,22157
728,59,female,rent,6188,3169,4814,1811,6696,22678
729,36,male,own,4022,2148,4122,5924,4553,20769
730,33,male,own,3338,3918,2321,5638,6435,21650
731,21,male,rent,5534,5953,749,4735,3198,20169
732,44,female,own,2008,5703,4144,2928,1733,16516
733,28,female,rent,8127,7038,4319,3641,5601,28726
734,37,female,own,5807,7963,2852,1062,3929,21613
735,29,female,own,3587,1108,2557,2255,1168,10675
736,23,female,rent,3176,7926,4534,3598,3759,22993
737,35,male,own,7225,2343,1913,6342,12700,30523
738,45,male,own,5875,7099,4255,2044,4859,24132
739,26,female,rent,2557,6462,3241,4378,1861,18499
740,32,male,own,7497,7606,3448,6785,1347,26683
741,23,male,own,3316,4740,2845,1301,7532,19734
742,41,male,own,5177,7546,4321,2170,2464,21678
743,22,male,own,8243,3014,1992,3006,8889,25144
744,30,male,own,2831,6444,3949,6004,6312,25540
745,28,male,own,5035,2436,3997,2978,11460,25906
746,23,female,rent,2700,5655,3494,3380,3890,19119
747,37,female,own,4131,2668,4880,2240,12600,26519
748,26,male,own,6284,4421,3163,1098,14874,29840
749,33,male,own,3921,2570,3351,5926,8181,23949
750,49,female,own,6939,7110,2941,6642,1900,25532
751,23,female,own,6430,5243,3672,6306,3365,25016
752,23,female,rent,5456,5340,1977,5813,11303,29889
753,25,female,own,3627,4121,2039,5762,1503,17052
754,55,male,free,4128,5250,1753,5186,6726,23043
755,32,female,rent,3379,6767,2973,2468,11358,26945
756,74,male,own,6279,5659,2373,4183,14819,33313
757,39,male,free,9861,3073,2889,5598,14730,36151
758,31,male,own,6120,7424,2838,3016,5362,24760
759,35,male,own,2534,4028,4158,1768,3331,15819
760,59,female,own,6033,2358,1639,6291,4011,20332
761,24,female,rent,6896,1356,3909,4606,7005,23772
762,24,male,own,3447,7124,3459,6799,3954,24783
763,30,male,free,3527,7771,2825,6580,4752,25455
764,27,male,own,2906,3508,1079,3583,11505,22581
765,40,male,own,3534,4945,2170,5959,10169,26777
766,31,male,own,2385,4389,1901,2859,11716,23250
767,31,female,rent,9311,2666,2579,3575,6423,24554
768,28,male,rent,3950,5985,3215,2419,2738,18307
769,63,male,own,9370,5066,2733,4101,10889,32159
770,26,female,rent,9616,5526,632,4209,14974,34957
771,25,female,own,7756,1002,2113,2164,4553,17588
772,36,male,own,3310,5865,4477,1720,6893,22265
773,52,male,own,2511,4281,2823,6575,1363,17553
774,66,male,free,3792,3926,2122,6387,8248,24475
775,25,female,rent,8197,7295,1994,5391,3226,26103
776,37,male,own,2084,7292,2490,5903,2795,20564
777,25,female,own,9972,7976,4179,5565,5636,33328
778,38,male,own,9755,3677,3875,1011,5510,23828
779,67,female,own,6931,5731,1371,3765,10822,28620
780,25,male,own,4194,6062,3017,1173,7976,22422
781,60,male,own,9028,2819,4615,3891,13581,33934
782,31,male,own,5102,6506,1815,3509,10878,27810
783,23,female,own,5849,1749,1066,4423,10835,23922
784,60,male,own,9410,3379,2497,4654,5409,25349
785,35,male,own,4083,3219,4262,6249,6994,24807
786,40,male,own,9462,3030,1607,6122,7847,28068
787,38,male,own,4931,3077,2288,1802,2240,14338
788,50,male,free,4004,5054,1038,4391,4333,18820
789,27,male,own,8645,5552,3481,3154,2721,23553
790,39,female,own,8217,5123,4642,6317,11194,35493
791,41,male,own,4523,1522,943,1888,4520,13396
792,27,male,own,4603,2612,4416,3205,4574,19410
793,51,male,free,5929,4818,4186,4021,10128,29082
794,32,male,rent,6118,2911,1576,1635,14704,26944
795,22,female,rent,2955,5324,1856,2202,6356,18693
796,51,male,free,9216,1232,4589,4113,9072,28222
797,22,female,rent,8991,5604,4086,1991,5221,25893
798,54,male,own,2882,4210,2688,5731,13055,28566
799,35,male,own,8965,2362,2539,4165,6959,24990
800,54,male,free,2651,7350,2771,2517,11114,26403
801,48,female,rent,9643,4977,968,4119,6013,25720
802,24,female,own,7045,1937,2391,5463,4934,21770
803,35,male,own,5333,6253,4168,4609,2423,22786
804,24,female,rent,7468,3580,2041,5665,1069,19823
805,24,male,own,3548,5201,1415,3188,11378,24730
806,26,male,own,6957,7364,3621,6778,12365,37085
807,65,male,own,8246,4200,4643,3835,3481,24405
808,55,male,free,7246,1290,3161,1368,3277,16342
809,26,female,rent,4506,4040,838,6667,10166,26217
810,26,male,own,7112,3567,1867,1230,11960,25736
811,28,male,own,3568,2580,1742,6126,8882,22898
812,24,male,own,9320,2878,4484,6413,4657,27752
813,54,male,own,7564,6788,1999,5285,12989,34625
814,46,male,free,6050,7251,1696,6329,7847,29173
815,54,female,rent,8506,1073,1774,1763,13976,27092
816,62,male,own,4091,1211,3516,1771,8801,19390
817,24,female,rent,9466,6158,3699,4132,11243,34698
818,43,male,own,7280,1129,735,5243,5421,19808
819,26,male,own,7565,7060,4656,2394,7956,29631
820,27,male,own,2805,3076,1558,1102,10044,18585
821,24,male,own,2490,3426,1572,5367,1914,14769
822,41,male,own,3503,4730,3515,5845,3521,21114
823,47,male,own,3610,6119,3523,5149,6236,24637
824,35,male,own,7179,6918,4192,3985,4859,27133
825,30,male,own,8241,5151,776,4024,6669,24861
826,33,female,rent,9579,2929,1090,5137,11707,30442
827,36,male,own,3801,6758,3386,1648,4720,20313
828,47,male,free,8324,2891,4596,6563,10002,32376
829,38,male,free,7883,2105,4052,2228,8308,24576
830,44,male,own,9199,4155,1229,3855,14363,32801
831,23,female,rent,3393,6954,1221,1948,14835,28351
832,29,male,rent,7645,6088,3391,1414,10006,28544
833,42,female,own,6933,4708,1138,2991,12180,27950
834,25,female,own,7592,4339,1568,2400,3336,19235
835,48,male,own,4003,6428,1198,1310,9397,22336
836,21,female,own,7228,3282,3106,1928,12052,27596
837,23,female,rent,2922,7409,525,5904,7397,24157
838,63,male,own,9843,3628,2937,4340,10197,30945
839,46,male,own,6579,7510,2314,2091,14186,32680
840,29,male,own,4720,1961,1163,3780,14517,26141
841,28,male,own,3181,7160,3405,1654,8779,24179
842,23,female,own,5426,2599,4760,4353,10872,28010
843,50,male,own,3757,4838,4432,2237,1024,16288
844,47,male,own,8259,6775,2758,5842,14157,37791
845,35,male,own,3363,2230,4360,4553,9684,24190
846,68,male,rent,4544,3458,3757,2853,8095,22707
847,28,male,own,2630,2430,4897,5021,14041,29019
848,59,male,own,2102,4257,1165,1145,11218,19887
849,57,male,own,4761,7118,3543,3938,14014,33374
850,33,male,rent,2465,7496,3781,4542,7894,26178
851,43,male,own,4038,2898,3163,5363,8577,24039
852,35,male,free,2035,4643,3738,4805,7566,22787
853,32,male,free,3480,4432,902,2969,13342,25125
854,45,male,own,8840,3448,4041,1284,2894,20507
855,33,male,own,7635,3905,2120,4589,1211,19460
856,40,female,own,8806,5345,3792,3241,1028,22212
857,28,male,free,4863,3292,3949,3640,4509,20253
858,29,female,own,6027,2037,1294,2828,6890,19076
859,26,male,rent,5559,2069,2831,1015,5285,16759
860,27,male,own,7562,1790,2552,4989,12789,29682
861,28,male,own,6975,4495,1219,5088,7787,25564
862,35,female,own,4709,5112,3608,4471,10586,28486
863,32,male,own,6702,2683,4534,5121,8980,28020
864,25,male,rent,4207,6194,4189,3831,12835,31256
865,20,female,rent,6507,2642,667,3609,5207,18632
866,27,female,own,2719,5497,4575,5858,8502,27151
867,42,male,own,7851,1320,729,5569,5666,21135
868,37,male,own,2147,5662,2016,3440,10684,23949
869,24,female,rent,6461,6053,3153,1664,2527,19858
870,40,female,own,6829,5019,3066,1296,14932,31142
871,46,male,own,6100,1603,1271,5722,8497,23193
872,26,male,own,9213,7453,2499,6782,13232,39179
873,24,female,own,6477,2715,1811,6948,14807,32758
874,29,male,own,7147,1474,1094,3858,7597,21170
875,40,female,own,7881,1088,629,5603,5262,20463
876,36,male,free,3954,5287,3510,6387,10036,29174
877,28,male,own,5888,3738,3121,3443,8785,24975
878,27,male,free,7705,7578,3028,6777,2908,27996
879,36,male,own,2317,1504,3571,1409,5939,14740
880,38,male,own,9289,5362,929,2031,2065,19676
881,48,male,free,7843,4474,3555,2111,14733,32716
882,36,male,own,6156,7916,4236,1129,13966,33403
883,65,female,own,4282,5400,2251,2493,3171,17597
884,43,male,own,6121,2220,3227,2761,1286,15615
885,53,female,own,9920,3848,3586,5624,11554,34532
886,34,male,own,9415,2034,535,4736,5959,22679
887,23,male,own,3120,4864,2691,4626,10751,26052
888,34,male,own,8415,2410,2796,1294,3474,18389
889,40,male,rent,3600,1912,1164,1877,3540,12093
890,43,male,own,2046,3060,1334,1501,2913,10854
891,46,male,own,4886,4737,3228,3254,14020,30125
892,38,male,own,8716,5658,3282,3585,10752,31993
893,34,male,own,8715,1909,3007,2799,2461,18891
894,29,male,own,5062,4221,2106,2354,3098,16841
895,31,male,own,2292,7802,1891,3727,1198,16910
896,28,female,rent,8604,2677,1146,6845,14444,33716
897,35,female,own,8235,3571,793,1999,7278,21876
898,33,female,rent,8725,4805,3856,6507,8722,32615
899,42,male,own,2549,7426,1210,3726,2644,17555
900,43,male,rent,6087,6916,1511,5607,5153,25274
901,44,male,own,4786,5998,4776,5628,7805,28993
902,42,male,free,5205,4778,2875,5157,14175,32190
903,40,male,rent,4565,2431,3682,6860,11200,28738
904,36,male,own,3642,1424,775,6960,2296,15097
905,20,male,rent,5709,5225,774,6906,12241,30855
906,24,male,own,2026,4673,2670,3600,4231,17200
907,27,male,own,6712,1132,2400,4522,9832,24598
908,46,female,own,3406,7181,1416,1225,5273,18501
909,33,female,own,4114,3528,4097,5573,6788,24100
910,34,female,own,9928,4517,4774,4459,10908,34586
911,25,female,own,9692,7216,4293,1251,6128,28580
912,25,female,own,3520,4765,3236,4586,1084,17191
913,28,male,own,4378,6528,1810,4448,11049,28213
914,31,male,rent,4280,6466,1874,6009,6141,24770
915,32,female,own,6489,1921,518,6895,12437,28260
916,32,male,own,7325,7027,971,6492,1799,23614
917,68,male,own,4205,3053,1497,2910,7652,19317
918,33,male,own,4946,6895,3081,4020,11245,30187
919,39,male,rent,8255,6614,3040,6136,7972,32017
920,28,female,own,2822,7603,1960,2811,11481,26677
921,37,male,own,5653,3349,4945,2439,11380,27766
922,22,female,rent,6771,2570,2079,6334,2851,20605
923,30,male,rent,4666,3253,1529,5068,7887,22403
924,55,male,own,4529,2626,2068,2174,10871,22268
925,46,male,own,4019,6224,2022,3960,14969,31194
926,21,female,rent,9614,6773,1793,5802,5983,29965
927,39,male,free,2810,4495,2851,3192,1888,15236
928,58,male,own,5521,4737,2392,1777,7415,21842
929,43,male,own,5989,1246,2770,5458,14910,30373
930,24,male,own,6598,4765,1209,5592,6701,24865
931,22,female,own,9113,6427,2386,6811,13897,38634
932,30,male,own,8862,6377,2584,6002,14612,38437
933,42,male,own,6484,6049,4777,5953,7680,30943
934,23,female,own,5545,1227,1288,5386,13605,27051
935,30,male,own,6028,7938,2631,6858,4071,27526
936,28,female,own,4546,6573,4030,1838,12420,29407
937,30,male,rent,8573,6103,3003,4273,14907,36859
938,42,male,free,6392,5892,2304,3273,12367,30228
939,46,male,own,2463,6652,4335,1616,3541,18607
940,45,male,own,8442,1193,4193,3800,5851,23479
941,31,male,own,5128,7278,3568,3371,14547,33892
942,31,male,own,4497,3130,4263,1717,2461,16068
943,42,male,own,8399,7210,2087,3784,4747,26227
944,46,female,rent,5170,3919,3370,6272,8184,26915
945,30,female,own,8028,2930,2243,3320,9569,26090
946,30,male,free,6306,5112,2913,5182,1707,21220
947,38,male,own,8146,4605,3979,1601,10691,29022
948,43,male,own,9537,4363,1468,1510,7567,24445
949,31,male,own,2623,1103,1885,1751,9583,16945
950,40,male,own,9695,2794,3784,3203,7890,27366
951,24,male,own,2310,5557,4565,6384,14268,33084
952,28,female,rent,8596,5278,4129,4313,9110,31426
953,26,female,own,6520,2402,2348,4794,3839,19903
954,29,female,own,9480,7454,4649,3738,12018,37339
955,57,female,rent,6336,5044,1994,3540,6024,22938
956,49,male,own,3986,5198,3124,1199,7503,21010
957,37,male,own,2826,2633,1684,2392,7656,17191
958,45,male,own,2896,3694,1551,6143,13558,27842
959,30,male,free,7045,6715,4995,2069,5414,26238
960,30,male,rent,3983,2879,4514,5872,13560,30808
961,47,male,own,6376,2563,3911,1931,8965,23746
962,29,male,own,2478,6114,4516,1454,5386,19948
963,35,male,own,3995,3583,1991,6771,14864,31204
964,22,male,own,3006,4869,912,2041,13387,24215
965,26,female,own,5032,1064,1012,2833,2361,12302
966,23,male,own,7880,3282,795,1736,2509,16202
967,54,female,rent,5930,6768,3821,1919,9363,27801
968,29,male,rent,7374,1598,4468,2798,10819,27057
969,40,male,own,6423,2807,4794,4373,9401,27798
970,22,male,own,6216,4871,4158,5516,8171,28932
971,43,male,own,9341,6178,1709,4998,2795,25021
972,29,female,rent,2203,5958,3821,5969,2853,20804
973,36,male,rent,6693,7669,4601,4523,14511,37997
974,33,female,own,4824,2201,1957,3060,10007,22049
975,57,female,own,3981,2556,3747,3533,2734,16551
976,64,female,own,4525,3179,2673,6115,5388,21880
977,42,male,own,5781,1778,4496,3073,10854,25982
978,47,male,own,9282,6528,4866,6699,1998,29373
979,25,male,rent,4927,7415,1929,6089,5638,25998
980,49,male,own,3519,7091,1115,6897,7438,26060
981,33,male,rent,8925,7228,3063,2607,7544,29367
982,28,female,own,4104,7587,3571,4008,8251,27521
983,26,male,own,6528,3355,3670,2156,8985,24694
984,30,male,own,4638,4731,1086,4007,8623,23085
985,25,female,rent,3242,2785,2775,6445,10296,25543
986,33,male,own,5640,1192,2681,5608,2450,17571
987,64,female,own,3637,6764,2243,1655,1656,15955
988,29,male,free,9871,3238,1777,2484,7155,24525
989,48,male,own,2376,1970,3452,5576,2127,15501
990,37,male,own,7273,2558,1816,6613,7240,25500
991,34,male,own,7368,6109,4698,4313,10051,32539
992,23,male,rent,3007,3938,1401,2679,13418,24443
993,30,male,own,7645,4932,1712,1012,6209,21510
994,50,male,own,7572,1329,3500,5165,2605,20171
995,31,female,own,6650,1368,1182,6676,14102,29978
996,40,male,own,2558,7229,4015,6727,1808,22337
997,38,male,own,2780,3729,2302,5056,3213,17080
998,23,male,free,7622,2360,3777,2603,9266,25628
999,27,male,own,2764,4869,1809,2983,4806,17231
